#######################################
#.....................................#
#.....................................#
#.....................................#
#.....................................#
#.....................................#
#.....................................#
#.....................................#
#.....................................#
#.....................................#
#.....................................#
#..........######.....................#
#...............#.....................#
#...............#.....................#
#...............#.....................#
#...............#.....................#
#.....................................#
#.....................................#
#.....................................#
#.....................................#
#................#....................#
#................#....................#
#................#....................#
#................#....................#
#................#....................#
#................#....................#
#.....................................#
#.....................................#
#.....................................#
#.....................................#
#.....................................#
#.....................................#
#.....................................#
#.....................................#
#.....................................#
#.....................................#
#.....................................#
#.....................................#
#######################################
